###################
#....#.......#....#
#.##.#.#####.#.##.#
#.#.............#.#
#.#.##.##.##.##.#.#
#......#...#......#
#.#.##.#####.##.#.#
#.#.............#.#
#.##.#.#####.#.##.#
#....#...p...#....#
###################